Level 4
2
3
###########
#      o ##
#      @@##
#  A##  o##
###########