Level 2
2
1
#########
####  o##
#### @@##
#### A o#
#########