Level 3
2
3
###########
# @    o ##
#        ##
#   ### A@#
###########