Level 2
2
1
#########
#o    o##
# @  @ ##
#o@  A @o#
#########