Level 3
1
2
#######
# @ o##
# ##  #
# A   #
#######