Level 5
3
4
#########
#o    o##
##@  @###
#o@  A @o#
#########